NO ./textures/brick.xpm
SO ./textures/blue.xpm
WE ./textures/wood.xpm
EA ./textures/grey.xpm

F 100,0,100
C 0,0,0

1 1 1 1 1 1 1 1 1 1 1 1 1 1 1 1 1 1 1 1 1 1 1 1 1 1 1 1 1
1 0 0 0 0 0 0 0 0 0 0 0 0 W 0 0 0 0 0 0 0 0 0 0 0 0 0 1 1
1 1 1 1 1 1 1 1 1 1 1 1 1 1 1 1 1 1 1 1 1 1 1 1 1 1 1 1 1

   111
   101
1111011111
100000N001
1111011111
   101
   111