NO ./textures/brick.xpm
SO ./textures/blue.xpm
WE ./textures/wood.xpm
EA ./textures/grey.xpm

F 100,1,100
C 10,10,10


1111
1001
10S1
1001
1111


