NO ./textures/brick.xpm
SO ./textures/blue.xpm
WE ./textures/wood.xpm
EA ./textures/grey.xpm

F 220,100,0
C 225,30,0






        11111111 1111111 111111111111111111111111111111
        10000001111100011100000000000000000000000000001
        10110000011100000000000000000000000000000000001
        10010000000000000000000000000000000000000000001
1111111110110000011100000000000000000000000000000000001
1000000000110000011101111110000000000000000000000111111
100000000000000011010100000000000000000000000000001
110000011101010111110111100000000000000000000000001
11110111 1110101 1011110100000000000000000000000001
11110111 1111111 1111111111111111111111111111111111
   101
   101
1111011111
100000001
1111011111
   1N1
   111