NO ./textures/brick.xpm
SO ./textures/blue.xpm
WE ./textures/wood.xpm
EA ./textures/grey.xpm

F 220,100,0
C 225,30,0

        11111111 1111111 11111111
        1000000111110001110000001
        1011000001110000000000001
        1001000000000000000000001
111111111011000001110000000000001
100000000011000001110111111111111
11110111111111011100000010001
11110111111111011101010010001
11000000110101011100000010001
10000000000000001100000010001
10000000000000001101010000001
11000001110101011111011110N01
11110111 1110101 101111010001
11110111 1111111 111111111111
   101
   101
1111011111
100000001
1111011111
   101
   111
